111111111111111111111111111111
100000000000000000000000111111
111100000000001111100000111001
100001111000000001111100000011
111000000000000000000000000001
100000000000000000000000111111
111100000000001111100000111001
100001111000000001111100000011
111000000000000000000000000001
111111111111111111111111111111
